BBBBBBBBBBBBBBBBBBBBBBBBBBBBBBBBBBBBBBBBBBBBBBBBBBBBBBBBBBBBBBBB
B00000000000000000000000000000000000000000000000000000000000000B
B00000000000000000000000000000000000000000000000000000000000000B
B00000000000000000000000000000000000000000000000000000000000000B
B00000000000000000000000000000000000000000000000000000000000000B
B00000000000000000000000000000000000000000000000000000000000000B
B00000000000000000000000000000000000000000000000000000000000000B
B00000000000000000000000000000000000000000000000000000000000000B
B00000000000000000000111110000000000011111000000000000000000000B
B00000000000000000000000000000000000000000000000000000000000000B
B00000000000000000000000000000000000000000000000000000000000000B
B00000000000000000000000000000000000000000000000000000000000000B
B00000000000000000000000000000000000000000000000000000000000000B
B00000000000000000000000000000000000000000000000000000000000000B
B00000000000001111111100000000000000000000111111110000000000000B
B00000000000000000000000000000000000000000000000000000000000000B
B00000000000000000000000000000000000000000000000000000000000000B
B00000000000000000000000000000000000000000000000000000000000000B
B00000000000000000000000000000000000000000000000000000000000000B
B00000000000000000000000000000000000000000000000000000000000000B
B00000000000000000000000000000000000000000000000000000000000000B
B00000111111111111000000000000000000000000000011111111111100000B
B00000000000000000000000000000000000000000000000000000000000000B
B00000000000000000000000000000000000000000000000000000000000000B
B00000000000000000000011111111111111111111100000000000000000000B
B00000000000000000000000000000000000000000000000000000000000000B
B00000000000000000000000000000000000000000000000000000000000000B
B00000000000000000000000000000000000000000000000000000000000000B
B00P0000000000000000000000000000000000000000000000000000000R000B
BBBBBBBBBBBBBBBBBBBBBBBBBBBBBBBBBBBBBBBBBBBBBBBBBBBBBBBBBBBBBBBB